8,8,8,8,8,8
8,2,1,1,3,8
8,5,0,2,3,8
8,3,4,0,6,8
8,3,7,7,6,8
8,8,8,9,8,8
