8,8,8,8,8,8
8,2,1,0,3,8
8,5,0,2,0,8
8,3,4,0,6,8
8,0,7,0,0,8
8,8,8,8,8,8
