8,8,8,8,8,8
8,2,4,1,1,8
8,4,6,0,0,8
8,5,6,7,7,8
8,3,3,5,2,8
8,3,3,4,5,8
8,9,8,8,8,8
