8,8,8,8,8,8,8
8,6,3,0,1,1,8
8,6,3,4,7,7,8
8,3,5,2,0,5,8
8,3,2,6,4,3,8
8,7,7,6,2,3,8
8,9,8,8,8,8,8
