8,8,8,8,8,8,8,8,8,8,8
8,8,8,8,6,3,0,8,8,8,8
8,8,8,8,6,3,5,8,8,8,8
8,8,5,2,5,2,4,0,6,8,8
8,8,1,1,4,5,2,5,6,8,8
8,8,8,8,0,7,7,8,8,8,8
8,8,8,8,0,4,0,8,8,8,8
8,0,2,5,3,2,6,4,5,0,8
8,7,7,0,3,5,6,2,2,5,8
8,9,8,8,8,8,8,8,8,8,8
