0,1,2,3,4,5,6,7,307
8,9,10,11,12,13,14,15,308
16,17,18,19,20,21,22,23,309
24,25,26,27,28,29,30,31,310
32,33,34,35,36,37,38,39,301
40,41,42,43,44,45,46,47,302
48,49,50,51,52,53,54,55,316
56,57,58,59,60,61,62,63,324
64,65,66,67,68,69,70,71,339
107,108,109,317,318,325,326,399,347
115,116,117,340,341,342,343,344,345
352,353,354,488,489,490,500,508,434
384,385,386,387,496,497,432,433,435
392,393,394,395,610,611,612,-1,-1
