123,124,125,428,429,430,498,499
131,132,133,436,437,438,506,507
264,265,266,267,268,269,270,271
272,273,274,275,276,277,278,279
362,363,364,365,366,367,566,567
370,371,372,373,374,375,574,575
537,538,539,581,582,583,584,585
545,546,547,589,590,591,592,593
553,554,555,597,598,599,600,601
565,573,605,606,607,613,614,615
