0,1,2,3,4,5,6,7
8,9,10,11,12,13,14,15
16,17,18,19,20,21,22,23
392,393,394,564,572,573,589,586
400,401,402,607,580,581,724,594
634,635,680,681,682,605,732,597
642,643,48,49,50,51,624,625
704,705,56,57,58,59,632,633
712,713,64,65,66,67,640,641
